 
1 2 3 2 2 2 2 2 3 2 3 2 3 4 2 3 4 
1 0 0 0 2 2 2 3 2 3 2 3 4 2 3 4 4
1 0 0 0 2 2 2 2 3 2 3 2 3 4 2 3 4 
1 0 0 0 2 2 2 2 3 2 3 2 3 4 2 3 4 
1 2 3 2 2 2 2 2 3 2 3 2 3 4 2 3 4 